###########
#    #$#  #
# #       #
#  ##    ##
#@        #
###########