###########
#    #$#  #
# # @#    #
#  ### # ##
#     ##  #
### #     #
###########