######
#$   #
# #@ #
# #  #
#   ##
######