#########
#$##    #
# # #  ##
#       #
# ##### #
#     @ #
#########
