###########
#$##      #
# # #  ####
#         #
# #####   #
#     @   #
###########