#######
#     #
# # ###
# #@& #
# # #%#
#   #$#
#######